31337 scroll	30669 scroll	668 scroll
64067 scroll	30669 scroll	33398 scroll
64735 scroll	64067 scroll	668 scroll
668 scroll	334 scroll	334 scroll
a little sump'm sump'm	little paper umbrella	martini
abridged dictionary	bridge	dictionary
alarming strawberry juice	scrumptious reagent	strawberry
arse-a'fire elixir	jaba&ntilde;ero pepper	scrumptious reagent
asbestos crossbow	asbestos crossbow string	asbestos meat stack
asbestos crossbow string	crossbow string	asbestos ore
asbestos helmet turtle	helmet turtle	asbestos meat stack
asbestos meat stack	asbestos ore	dense meat stack
asbestos staff	asbestos stick	asbestos meat stack
asbestos stick	big stick	asbestos ore
asbestos sword	asbestos meat stack	asbestos sword hilt
asbestos sword hilt	asbestos ore	sword hilt
asparagus stir-fry	stalk of asparagus	secret blend of herbs and spices
asshat	bum cheek	bum cheek
balloon helmet	long skinny balloon	long skinny balloon
balloon monkey	balloon sword	long skinny balloon
balloon sword	balloon helmet	long skinny balloon
barskin tent	bar skin	wooden stakes
bartender skull	brainy skull	beer goggles
bartender-in-the-box	bartender-skull-in-the-box	cocktailcrafting kit
bartender-skull-in-the-box	nothing-in-the-box	bartender skull
basic meat crossbow	crossbow string	meat stack
basic meat fez	basic meat helmet	tassel
basic meat foon	foon	meat stack
basic meat helmet	meat stack	helmet recipe
basic meat pants	meat stack	pants kit
basic meat spork	meat stack	spork
basic meat staff	big stick	meat stack
basic meat sword	sword hilt	meat stack
bat haggis	batgut	spices
bat wing chow mein	bat wing stir-fry	dry noodles
bat wing kabob	bat wing	skewer
bat wing stir-fry	bat wing	Knoll stir-fry
bean burrito	flat dough	beans
beanbag chair	beans	filthy knitted dread sack
beer goggles	beer lens	beer lens
Bjorn's Hammer	seal-clubbing club	seal-toothed rock
bloody mary	tomato	bottle of vodka
bone rattle	skeleton bone	broken skull
boring spaghetti	dry noodles	tomato
Boris's key lime	Boris's key	lime
Boris's key lime pie	Boris's key lime	pie crust
bow staff	big stick	bow
bowlegged pants	basic meat pants	bow
bowler	basic meat helmet	bow
box-in-the-box	box	nothing-in-the-box
box-in-the-box-in-the-box	box	nothing-in-the-box-in-the-box
brainy skull	disembodied brain	smart skull
briny vinegar	brine	vinegar
carob brownies	carob chunks	Uncle Jick's Brownie Mix
carob-chunk cookies	carob chunks	wad of dough
charrrm bracelet	hemp bracelet	charrrm
chef skull	brainy skull	chef's hat
chef-in-the-box	chef-skull-in-the-box	E-Z Cook Oven™
chef-skull-in-the-box	nothing-in-the-box	chef skull
chorizo taco	uncooked chorizo	taco shell
chrome crossbow	chrome crossbow string	chrome meat stack
chrome crossbow string	chrome ore	crossbow string
chrome helmet turtle	chrome meat stack	helmet turtle
chrome meat stack	dense meat stack	chrome ore
chrome staff	chrome stick	chrome meat stack
chrome stick	big stick	chrome ore
chrome sword	chrome sword hilt	chrome meat stack
chrome sword hilt	chrome ore	sword hilt
Clockwork Maid	frilly skirt	meat engine
cocoa egg	large cocoa eggshell fragment	large cocoa eggshell fragment
cog and sprocket assembly	cog	sprocket assembly
cosmic lemonade	lemon	scrumptious reagent
cottage	anticheese	bowl of cottage cheese
cranmopolitan	vodka and cranberry	skewered cranberry
Crimbo hat	wrapping paper	helmet recipe
Crimbo pants	wrapping paper	pants kit
Crimbo sword	wrapping paper	sword hilt
delicious noodles	dry noodles	herbs
delicious spicy noodles	dry noodles	secret blend of herbs and spices
detective skull	gnoll lips	brainy skull
dill potion	dill	scrumptious reagent
dirty martini	skewered olive	martini
Disco Banjo	disco ball	stone banjo
dope wheels	tires	sweet rims
drab potion	olive	scrumptious reagent
dripping meat crossbow	basic meat crossbow	ketchup
dripping meat staff	basic meat staff	ketchup
dripping meat sword	basic meat sword	ketchup
eggnog	ghuol egg	spiced rum
enchanted bean burrito	flat dough	enchanted bean
enchanted eyepatch	eyepatch	lihc eye
equilibrium juice	scrumptious reagent	lime
especially salty dog	salty dog	brine
evil golden arches	evil golden arch	evil golden arch
extra-spicy bloody mary	bloody mary	spices
eXtreme meat crossbow	basic meat crossbow	stone of eXtreme power
eXtreme meat staff	basic meat staff	stone of eXtreme power
eXtreme meat sword	stone of eXtreme power	basic meat sword
eXtreme nose ring	stone of eXtreme power	piercing post
fancy schmancy cheese sauce	scrumptious reagent	goat cheese
fertilized ghuol egg	ghuol egg	Spooky-Gro fertilizer
fettucini Inconnu	fancy schmancy cheese sauce	dry noodles
fine wine	grapes	fermenting powder
full meat tank	empty meat tank	meat stack
furry pants	furry fur	pants kit
fuzzbump	grog	little paper umbrella
ghostly pickling solution	briny vinegar	dill
ghuol egg quiche	ghuol egg	pie crust
ghuol-ear kabob	ghuol ears	skewer
gnatwing earring	gnatwing	piercing post
gnocchetti di Nietzsche	Himalayan Hidalgo sauce	dry noodles
gnoll-tooth necklace	gnoll teeth	necklace chain
Gnollish autoplunger	Gnollish plunger	meat engine
goat	anticheese	goat cheese
goat cheese pizza	plain pizza	goat cheese
grapefruit juice of powerful power	grapefruit	scrumptious reagent
grog	bottle of rum	lime
grogtini	skewered lime	grog
heart of rock and roll	big rock	hot buttered roll
heavy hot sauce	big rock	jaba&ntilde;ero pepper
heavy metal sonata	chrome ore	drab sonata
heavy metal thunderrr guitarrr	acoustic guitarrr	chrome ore
Hell broth	scrumptious reagent	hellion cube
Hell ramen	Hell broth	dry noodles
herb brownies	herbs	Uncle Jick's Brownie Mix
Himalayan Hidalgo sauce	Knob mushroom	scrumptious reagent
hippopotamus pants	pants kit	hippopotamus skin
hippy herbal tea	guano coffee cup	herbs
horizontal tango	whiskey sour	little paper umbrella
icy-hot katana	icy katana hilt	hot katana blade
insanely spicy bean burrito	spicy bean burrito	jaba&ntilde;ero pepper
insanely spicy enchanted bean burrito	spicy enchanted bean burrito	jaba&ntilde;ero pepper
Jarlsberg's key lime	Jarlsberg's key	lime
Jarlsberg's key lime pie	Jarlsberg's key lime	pie crust
Kentucky-fried meat crossbow	secret blend of herbs and spices	basic meat crossbow
Kentucky-fried meat staff	secret blend of herbs and spices	basic meat staff
Kentucky-fried meat sword	secret blend of herbs and spices	basic meat sword
Knob sausage chow mein	Knob sausage stir-fry	dry noodles
Knob sausage stir-fry	Knob sausage	Knob stir-fry
Knob stir-fry	Knob mushroom	secret blend of herbs and spices
Knoll stir-fry	Knoll mushroom	secret blend of herbs and spices
large cocoa eggshell fragment	cocoa eggshell fragment	cocoa eggshell fragment
lifeless meat doll	meat face	wooden figurine
lihc eye pie	lihc eye	pie crust
linoleum crossbow	linoleum meat stack	linoleum crossbow string
linoleum crossbow string	linoleum ore	crossbow string
linoleum helmet turtle	helmet turtle	linoleum meat stack
linoleum meat stack	dense meat stack	linoleum ore
linoleum staff	linoleum meat stack	linoleum stick
linoleum stick	big stick	linoleum ore
linoleum sword	linoleum meat stack	linoleum sword hilt
linoleum sword hilt	linoleum ore	sword hilt
martini	olive	bottle of gin
meat cowboy hat	basic meat helmet	whitesnake skin
meat engine	full meat tank	cog and sprocket assembly
meat face	fairy gravy	dried face
meat golem	lifeless meat doll	magicalness-in-a-can
meatloaf helmet	basic meat helmet	ketchup
menudo	catgut	spices
mushroom pizza	plain pizza	Knob mushroom
ND	lowercase N	heavy D
NG	lowercase N	original G
nothing-in-the-box	box	spring
nothing-in-the-box-in-the-box	box-in-the-box	spring
ocean motion	strawberry daiquiri	little paper umbrella
olive stir-fry	secret blend of herbs and spices	olive
one-winged stab bat	batblade	bat wing
orangish aphrodisiac	orange	scrumptious reagent
painful penne pasta	dry noodles	jaba&ntilde;ero pepper
papaya sling	papaya	bottle of gin
papaya taco	papaya	taco shell
papotion of papower	papaya	scrumptious reagent
Pasta of Peril	spaghetti with rock-balls	pasta spoon
penguin shorts	penguin skin	pants kit
phat turquoise bracelet	hemp bracelet	phat turquoise bead
pie crust	Gnollish pie tin	wad of dough
pimpin' meat hat	basic meat helmet	bling-bling
pink pony	vodka and cranberry	little paper umbrella
pirate skull	eyepatch	brainy skull
plain pizza	flat dough	tomato
potion of chalky equality	scrumptious reagent	cranberries
potion of temporary gr8tness	scrumptious reagent	gr8ps
pr0n chow mein	pr0n stir-fry	dry noodles
pr0n cocktail	pr0n legs	ketchup
pr0n m4nic0tti	dry noodles	pr0n legs
pr0n stir-fry	pr0n legs	olive stir-fry
pregnant mushroom	Knob mushroom	fairy gravy
present	box	wrapping paper
pretty bouquet	pretty flower	pretty flower
rat appendix chow mein	rat appendix stir-fry	dry noodles
rat appendix stir-fry	rat appendix	spooky stir-fry
rat appendix-kabob	rat appendix	skewer
ravioli della hippy	wad of tofu	dry noodles
really really sticky spider web	really sticky spider web	really sticky spider web
really sticky spider web	spider web	spider web
rewinged stab bat	bat wing	one-winged stab bat
Rock and Roll Legend	heart of rock and roll	stolen accordion
rockin' wagon	rum and cola	little paper umbrella
roll in the hay	whiskey and cola	little paper umbrella
rum and cola	bottle of rum	Dyspepsi-Cola
sabre-toothed lime cub	lime	sabre teeth
salty dog	bottle of gin	grapefruit
sauce of the ages	Knob sausage	scrumptious reagent
sausage pizza	plain pizza	Knob sausage
screwdriver	bottle of vodka	orange
seal-toothed rock	big rock	seal tooth
secret blend of herbs and spices	herbs	spices
shot of grapefruit schnapps	grapefruit	fermenting powder
shot of orange schnapps	orange	fermenting powder
shot of tomato schnapps	fermenting powder	tomato
shroomkabob	Knoll mushroom	skewer
skeleton key	skeleton bone	loose teeth
skewered cat appendix	cat appendix	skewer
skewered cranberry	cranberries	tiny plastic sword
skewered lime	lime	tiny plastic sword
skewered olive	olive	tiny plastic sword
slap and tickle	salty dog	little paper umbrella
slip 'n' slide	screwdriver	little paper umbrella
Sneaky Pete's key lime	Sneaky Pete's key	lime
Sneaky Pete's key lime pie	Sneaky Pete's key lime	pie crust
spaghetti with rock-balls	big rock	ravioli hat
spaghetti with Skullheads	sauce of the ages	dry noodles
spectral pickle	ghost cucumber	ghostly pickling solution
spiced rum	bottle of rum	spices
spicy bean burrito	bean burrito	spices
spicy enchanted bean burrito	enchanted bean burrito	spices
spicy noodles	dry noodles	spices
spooky scarecrow	wooden stakes	spooky staff
spooky staff	spooky shrunken head	spooky stick
spooky stir-fry	spooky mushroom	secret blend of herbs and spices
sprocket assembly	sprocket	spring
sticky meat pants	really really sticky spider web	basic meat pants
stone banjo	big rock	banjo strings
strawberry daiquiri	bottle of rum	strawberry
stuffed spooky mushroom	spooky mushroom	goat cheese
T-bone key	rusty L-shaped piece of metal	crusty L-shaped piece of metal
Talisman o' Nam	snakehead charrrm	snakehead charrrm
tambourine	Gnollish pie tin	tambourine bells
tofu casserole	wad of tofu	Gnollish casserole dish
tofu chow mein	tofu stir-fry	dry noodles
tofu stir-fry	wad of tofu	asparagus stir-fry
tomato smoothie	tomato	scrumptious reagent
turtle factory	big rock	tortoise's blessing
Turtleslinger	slingshot	turtle factory
vodka and cranberry	bottle of vodka	cranberries
WA	metallic A	ruby W
Wand of Nagamar	WA	ND
wang	WA	NG
whiskey and cola	Dyspepsi-Cola	bottle of whiskey
whiskey sour	bottle of whiskey	lemon
white Canadian	bottle of vodka	glass of goat's milk
white chocolate chip cookies	white chocolate chips	wad of dough
wrath serum	grapes	scrumptious reagent
yakskin pants	pants kit	yak skin